-17
18
-9
9
111111111111111111111111111111111111
000000000000000000000000000000000001
000000000000000000000000000000000001
000000000000000000000000000000000001
000000000000000000000000000000000001
000000000000000000000000000000000001
000000000000000000000000000000000001
000000000000000000000000000000000001
000000000000000000000000111110000001
000000000000000000000000111110000001
000000000000000000000000111110000001
000000000000000000000000111110000001
000000000000000000000000111110000001
000000000000000000000000111110000001
000000000000000000000000000000000001
000000000000000000000000000000000001
000000000000000000000000000000000001
000000000000000000000000000000000001
000000000000000000000000000000000001
